HHHHHHHHHHHHHHHHHHHHHHHHHHHHHHHHHHHHHHHHHHHHHHHHHHHHHHHHHHHHHH
HHHHHHHHHHHHH1 HHHHH 2HHHHH3 HHHH 4HHHH5 HHHH6 HHHHHHHHHHHHHHH
#######HHHHHH  HHHHH  HHHHH  HHHH  HHHH  HHHH  HHHHH       7  
#     #HHHHHH  HHHHH  HHHHH  HHHH  HHHH  HHHH  HHHHH          
#     #HHHHHH  HHHHH  HHHHH  HHHH  HHHH  HHHH  HHHHH  ####  ## 
#P                                                    HHH#  ##
#                                                     HHH#  ##
#     #HHHHHH  HHHHH  HHHHH  HHHH  HHHH  HHHH  HHHHH  ####  ##
#     #HHHHHH  HHHHH  HHHHH  HHHH  HHHH  HHHH  HHHHH          
#######HHHHHH  HHHHH  HHHHH  HHHH  HHHH  HHHH  HHHHH       7   
HHHHHHHHHHHHH 1HHHHH 2HHHHH 3HHHH 4HHHH 5HHHH 6HHHHHHHHHHHHHHH
HHHHHHHHHHHHHHHHHHHHHHHHHHHHHHHHHHHHHHHHHHHHHHHHHHHHHHHHHHHHHH
