############
#P   # 1   #
#    #     #
#    #     #
#    #     #
#    #      
#    #      
#H  H#      
#    #     #
#          #
#          #
#HHHH# 1   #
############