#######################
#P         #          #
#     H    #   #   H  #
#          #   #   H  #
#   ########   #      #
#   #         ####    #
#   #            #    #
#         #########   #
#     #####H         H#
#         ####   ######
#1       1##
#######################