#############################################
#P     ######  2#######    #3        3    H##
#      ######            ###            # #  
#      ######   ############  H####H  # # # #
#   ##########  ############  ######  # # # #
#   ##########      4    4    ######  # # # #
# 1       1###                ######  # # # #
#   ##########  ####  ###  #  ######  # # # #
#               ####  ###  #  ######  # # # #
#              2####  ###  #  H####H  # #   #
#   ################                  # #####
#5                5 4    4  3        3#     #
#############################################